ask — спрашивать

accept — принимать(предложение, идею)

afford — позволять себе(финансово)

agree — соглашаться

allow — разрешать

announce — объявлять

apologize — извиняться

appear — появляться

arrive — прибывать

avoid — избегать

become — становиться

begin — начинать

believe — верить

bring — приносить

build — строить

buy — покупать

beat — бить(побеждать)

borrow — занимать(в долг)

break — ломать

burn — гореть/жечь

be — быть

call — звать/называть/звонить

can — мочь/уметь (модальный глагол)

carry — нести/переносить

catch — ловить/поймать

change — менять(ся)/изменять

come — приходить/приезжать

continue — продолжать

cost — стоить(о цене)

celebrate — праздновать

check — проверять

choose — выбирать

clean — чистить/убирать

climb — карабкаться/взбираться

close — закрывать

compare — сравнивать

complain — жаловаться

cook — готовить(еду)

copy — копировать

correct — исправлять

cry — плакать/кричать

cut — резать

consider — считать/рассматривать

cover — покрывать/закрывать

cause — вызывать/быть причиной

do — делать

drink — пить

drive — водить(машину)

dance — танцевать

decide — решать

deliver — доставлять

describe — описывать

discover — открывать(делать открытие)

discuss — обсуждать

divide — делить

double — удваивать

doubt — сомневаться

drag — тащить

draw — рисовать

dress — одеваться

drop — ронять

dry — сушить

die — умирать

develop — развивать(ся)

dare — сметь/осмеливаться

eat — есть(кушать)

earn — зарабатывать

enjoy — наслаждаться

escape — убегать/избегать

explain — объяснять

expect — ожидать

feel — чувствовать

find — находить

forget — забывать

fall — падать

feed — кормить

fight — бороться/драться

fill — заполнять

finish — заканчивать

fly — летать

follow — следовать

force — заставлять

freeze — замерзать/замораживать

fry — жарить

get — получать/становиться

give — давать

go — идти/ехать

grow — расти/выращивать

guess — угадывать

happen — случаться

hate — ненавидеть

have — иметь

hear — слышать

help — помогать

hide — прятать(ся)

hit — ударять

hold — держать

hope — надеяться

hurt — причинять боль/болеть

identify — идентифицировать

imagine — представлять/воображать

improve — улучшать

include — включать

increase — увеличивать

introduce — представлять(кого-то)/внедрять

invite — приглашать

involve — вовлекать

join — присоединяться

jump — прыгать

keep — сохранять/продолжать

kill — убивать

kiss — целовать

know — знать

laugh — смеяться

love — любить

lead — вести/руководить

learn — учить(ся)

leave — покидать/оставлять

lend — одалживать(давать взаймы)

let — позволять

like — нравиться

listen — слушать

live — жить

look — смотреть/выглядеть

lose — терять

make — делать/создавать

mean — означать/иметь в виду

move — двигать(ся)/переезжать

manage — управлять/справляться

marry — жениться/выходить замуж

measure — измерять

meet — встречать(ся)

miss — скучать/пропускать

need — нуждаться

notice — замечать

obey — подчиняться

offer — предлагать

open — открывать

organize — организовывать

owe — быть должным

own — владеть

pass — проходить/передавать

pay — платить

perform — выполнять/исполнять

pick — выбирать/собирать(ягоды)

plan — планировать

play — играть

practice — практиковать

prefer — предпочитать

prepare — готовить(ся)

present — представлять/дарить

pretend — притворяться

prevent — предотвращать

produce — производить

protect — защищать

prove — доказывать

pull — тянуть

push — толкать

put — класть/ставить

provide — обеспечивать

point — указывать

place — размещать

read — читать

run — бежать

raise — поднимать

reach — достигать

realize — осознавать

receive — получать

recognize — узнавать

record — записывать

reduce — уменьшать

refuse — отказывать

regret — сожалеть

relate — соотносить

relax — расслабляться

remember — помнить

remove — удалять

repeat — повторять

replace — заменять

reply — отвечать

report — сообщать

require — требовать

return — возвращать

ride — ездить верхом

ring — звонить

rise — подниматься

roll — катиться

remain — оставаться

represent — представлять(кого-то)

save — спасать/сохранять

say — говорить/сказать

see — видеть

sell — продавать

send — отправлять

serve — обслуживать/служить

set — устанавливать

settle — устраивать/улаживать

shake — трясти/пожимать(руку)

share — делиться

shoot — стрелять

show — показывать

shut — закрывать

sign — подписывать

sing — петь

sit — сидеть

sleep — спать

smile — улыбаться

solve — решать(проблему)

speak — говорить

spend — тратить(время/деньги)

stand — стоять

start — начинать

stay — оставаться

steal — красть

stop — останавливать(ся)

suggest — предлагать

supply — поставлять

support — поддерживать

suppose — полагать

surprise — удивлять

swim — плавать

seem — казаться

take — брать

talk — разговаривать

teach — учить(обучать)

tell — рассказывать

tend — иметь тенденцию

test — проверять

thank — благодарить

think — думать

throw — бросать

touch — касаться

train — тренировать(ся)

travel — путешествовать

treat — лечить/относиться

try — пытаться

turn — поворачивать(ся)

understand — понимать

use — использовать

visit — посещать

wait — ждать

walk — гулять/идти пешком

want — хотеть

watch — смотреть(наблюдать)

win — побеждать

wish — желать

work — работать

worry — беспокоиться

write — писать

wear — носить(одежду)

yell — кричать

can — мочь(уметь)

may — можно(разрешение)

must — должен

shall — должен(формальное будущее)

will — буду(вспомогательный глагол)

ought to — следует(моральный долг)